################.####
#............#......#
#.....#.............#
#..####...........###
#...#.#.............#
....#.......#.......#
#..####.....#.......#
#...........####....#
#...s...1...#.......#
#..........##.......#
#........#..#.......#
#....######.#........
#...................#
#...............#...#
#####################
end-layout
1:basic melee creature
end-entities